W,W,W,W
W,F,F,W
W,F,F,W
W,F,F,W
W,F,F,W
W,P,P,W
W,W,W,W