W,W,W,W,W,W,W
W,F,F,F,F,F,W
W,B,B,B,B,B,W
W,B,B,F,F,F,W
W,W,W,W,W,W,W