W,W,W,W,W,W,W,W,W,W
W,F,F,F,F,F,F,F,F,W
W,F,F,F,F,F,F,F,F,W
W,F,F,F,F,F,F,F,F,W
W,F,F,F,F,F,F,F,F,W
W,F,F,F,P,B,S1,H1,F,W
W,F,F,F,F,F,F,F,F,W
W,F,F,F,F,F,F,F,F,W
W,F,F,F,F,F,F,F,F,W
W,W,W,W,W,W,W,W,W,W