W,W,W,W,W,W,W,W,W,W
W,F,F,F,F,F,F,F,F,W
W,F,F,F,F,F,F,F,F,W
W,F,F,F,F,F,F,F,F,W
W,F,F,F,F,F,F,F,F,W
W,F,P,B,P,F,F,F,F,W
W,F,F,F,F,F,F,F,F,W
W,F,F,F,F,F,F,F,F,W
W,F,F,F,F,F,F,F,F,W
W,W,W,W,W,W,W,W,W,W