W,W,W,W,W,W,W,W,W,W
W,F,F,F,F,F,F,F,F,W
W,F,F,F,F,F,F,F,F,W
W,F,F,F,F,F,F,F,F,W
W,F,F,F,F,F,F,F,F,W
W,F,F,F,P,W,F,F,F,W
W,F,F,F,F,F,F,F,F,W
W,F,F,F,F,F,F,F,F,W
W,F,F,F,F,F,F,F,F,W
W,W,W,W,W,W,W,W,W,W