W,W,W,W,W,W,W,W,W,W,W,W,W,W,W
W,F,F,F,F,F,F,F,F,F,F,F,F,F,W
W,P,B,B,B,B,B,B,B,B,B,B,F,F,W
W,F,F,F,F,F,F,F,F,F,F,F,F,F,W
W,W,W,W,W,W,W,W,W,W,W,W,W,W,W