W,W,W,W,W,W
W,F,F,F,F,W
W,F,F,P,B,W
W,F,F,W,F,W
W,W,W,W,W,W