W,W,W,W,W,W
W,F,F,F,F,W
W,F,P,P,F,W
W,F,F,F,F,W
W,W,W,W,W,W