W,W,W,W,W,W,W,W,W,W,W,W
W,F,F,F,F,F,F,F,F,F,F,W
W,F,F,F,F,F,F,F,F,F,F,W
W,F,F,F,F,P,F,F,F,B,P,W
W,F,F,F,F,F,F,F,F,B,P,W
W,F,F,F,F,F,F,F,F,B,P,W
W,F,F,F,F,F,F,F,F,B,P,W
W,F,F,F,F,F,F,F,F,F,F,W
W,W,W,W,W,W,W,W,W,W,W,W