W,W,W,W,W,W,W,W,W,W
W,F,F,F,W,W,F,F,F,W
W,F,T,F,F,F,F,T,F,W
W,F,F,F,F,F,F,F,F,W
W,F,F,S1,F,F,S2,F,F,W
W,F,F,F,P,P,F,F,F,W
W,F,F,B,B,B,B,F,F,W
W,F,T,H1,F,F,H2,T,F,W
W,F,F,F,W,W,F,F,F,W
W,W,W,W,W,W,W,W,W,W