W,W,W,W,W,W,W,W,W,W
W,F,F,F,F,F,F,F,F,W
W,F,F,T,F,F,T,F,F,W
W,F,B,F,F,F,F,B,F,W
W,F,F,F,P,P,F,F,F,W
W,F,F,B,F,F,F,F,F,W
W,F,F,T,F,F,F,T,F,W
W,F,F,F,F,B,F,F,F,W
W,F,F,F,F,F,F,F,F,W
W,W,W,W,W,W,W,W,W,W